NO ./textures/SUPPORT_1A.xpm
SO ./textures/SUPPORT_1C.xpm
WE ./textures/SUPPORT_1D.xpm
EA ./textures/SUPPORT_2B.xpm


C 0, 0, 0
F 54, 69, 68


        1111111111111111111111111
        1000000000110000000000001
        1011000001110000000000001
        100100000000000E000000001
111111111011000001110000000000001
100000000011000001110111111111111
11110111111111011100000010001
11110111111111011101010010001
11000000110101011100000010001
10000000000000001100000010001
10000000000000001101010010001
11000001110101011111011011011
11110111 1110101 101111000001
11111111 1111111 111111111111