NO ./text/meast.xpm
SO ./text/meast.xpm
WE ./text/meast.xpm
EA ./text/meast.xpm

F 220,100,0
C 255,30,0
              1111111111
              1000000001
              1001111011
              1000001001
              1000001101
              1000001001
              1000111011
              1000100001
        1111111111101111111111111
        1000000000001000000000001
        1011000001111001000000001
        1001000000000000000010001
111111111011000001110000000000001
100000000011000001110111111111111
11110111111111011100000010001
11110111111111011101010010001
11000000110101011100000010001
10000000000000001100000010001
100N0000000000001101010010001
11000001110101011111011110001
10100111 1110101 101111010001
10001111 1111111 111111111111
11011
10001
10001
10001
11111